NO ./resources/textures/Wall.xpm 
SO ./resources/textures/Wall.xpm 
F      220,100,0

WE ./resources/textures/Wall.xpm 
EA ./resources/textures/Wall.xpm 


C 0,0,33

        1111111111111111111111111    111
        1000000000110000000000001    001
        10110000011100000000000011111101
        10010000000000000000000000000001
1111111110110000011100000000000011111111
100000000011000001110111111111111
11110111111111011100000010001
11110111111111011101010010001
11000000110101011100000010001
10000000000000001100000010001
1000000N000000001101010000001
1100000111010101111101111000111
11110111 1110101 101111010001
11111111 1111111 1111111111111

















