NO ./resources/textures/Ground.xpm
SO ./resources/textures/Stone1L.xpm

WE ./resources/textures/SnowbrickL.xpm
EA ./resources/textures/MultibrickL.xpm

C 255,100,100
F 100,255,100

1111111111111111111111
1111111111111111111111
        1111111111111111111111111    111
        1000000000110000000000001    101
        1011000X011100000000000011111101
        10010XGX000000000000000000000001
        10010X0X100000000000000000000001
        10010X01S00000000000000000000001
        10010000000000000000000000000001
        10010000000000000000000000000001
        10010000000000000000000000000001
        10010000000000000000000000000001
        10010000000000000000000000000001
        10010000000000000000000000000001
        10010000000000000000000000000001
        10010000000000000000000000000001
        10010000000000000000000000000001
        10010000000000000000000000000001
        10010000000000000000000000000001
        10010000000000000000000000000001
        10010000000000000000000000000001
        10010000000000000000000000000001
        10010000000000000000000000000001
        10010000000000000000000000000001
        10010000000000000000000000000001
        10010000000000000000000000000001
        10010000000000000000000000000001
        10010000000000000000000000000001
        100100000000000000000000000000011111111111111111111111111
        100100000000000000000000000000000000000000000000000000001
        100100000000000000000000000000011111111111111111111111111
1111111110110000011100000000000011111111
11111111101100G0011100000000000011111111
10000000001100G001110111111111111
111101111111D1D11100000010001
11110111111111D11101010010001
11000000110101D1110000001000111111
1000000111111000D000001100000010001
1000000000000000110101000000111111
1100000111010101111101111000111
11110111 1110101 101111010001
11111111 1111111 101111111111
1111111111111111111111111111111















