NO ./resources/textures/Wall.xpm
SO ./resources/textures/Wall.xpm

WE ./resources/textures/Wall.xpm
EA ./resources/textures/Wall.xpm

C 0,0,33
F 220,100,0

1111111111111111111111
1111111111111111111111
        1111111111111111111111111    111
        1000000000110000000000001    101
        10110000011100000000000011111101
        10010N00000000000000000000000001
1111111110110000011100000000000011111111
100000000011000001110111111111111
111101111111D1D11100000010001
11110111111111D11101010010001
11000000110101D1110000001000111111
1000000111111000D000001100000010001
1000000000000000110101000000111111
1100000111010101111101111000111
11110111 1110101 101111010001
11111111 1111111 101111111111
1111111111111111111111111111111















