NO ./resources/textures/Ground.xpm
SO ./resources/textures/Stone1L.xpm

WE ./resources/textures/SnowbrickL.xpm
EA ./resources/textures/MultibrickL.xpm

C 255,100,100
F 100,255,100

1111111111111
1001000000001
1001000010001
1001000000001
1001000000001
1001000000001
1001E00000G01
1001000000001
1111111111111














