NO ./resources/textures/Ground.xpm
SO ./resources/textures/Door.xpm

WE ./resources/textures/Star2.xpm
EA ./resources/textures/Exit.xpm

C 255,100,100
F 100,255,100

1111111111111111111111
1111111111111111111111
        1111111111111111111111111    111
        1000E00000110000000000001    101
        101100G0011100000000000011111101
        100100G0000000000000000000000001
        10010000000000000000000000000001
        10010000000000000000000000000001
        10010000000000000000000000000001
        10010000000000000000000000000001
        10010000000000000000000000000001
        10010000000000000000000000000001
        10010000000000000000000000000001
        10010000000000000000000000000001
        10010000000000000000000000000001
        10010000000000000000000000000001
        10010000000000000000000000000001
        10010000000000000000000000000001
        10010000000000000000000000000001
        10010000000000000000000000000001
        10010000000000000000000000000001
        10010000000000000000000000000001
        10010000000000000000000000000001
        10010000000000000000000000000001
        10010000000000000000000000000001
        10010000000000000000000000000001
        10010000000000000000000000000001
        10010000000000000000000000000001
        10010000000000000000000000000001
        10010000000000000000000000000001
1111111110110000011100000000000011111111
11111111101100G0011100000000000011111111
10000000001100G001110111111111111
111101111111D1D11100000010001
11110111111111D11101010010001
11000000110101D1110000001000111111
1000000111111000D000001100000010001
1000000000000000110101000000111111
1100000111010101111101111000111
11110111 1110101 101111010001
11111111 1111111 101111111111
1111111111111111111111111111111















