NO ./resources/textures/Stone1L.xpm
SO ./resources/textures/SnowbrickL.xpm

WE ./resources/textures/BookshelfL.xpm
EA ./resources/textures/MultibrickL.xpm

C 255,100,100
F 100,255,100

1111111111111111111111
1011111111111111111111
111     1111111111111111111111111    111
        1000000000110000000000001    101
        10110000011100000000000011111101
        10010000000000000000000000000001
1111111110110000011100000000000011111111
100000000011000001110111111111111
11110111111101011100000010001
11110111111111011101010010001
1100000011010101110000001000111111
10000001111110000000001100000010001
1000000000000000110101000000111111
1100000111010101111101111000111
11110111 1110101 10111101D001
11111111 1111111 1011111111S1
1111111111111111111111111111111